#####################
#X00000#000000000000#
#######0###########0#
###############00000#
#0000000000000000000#
##############00000##
#E000000000000#######
#####################
